%%%%%%%
% %%%%%
%     %
% %% %%
% %%.%%
% %  %%
% % %%%
%P    %
%%%%%%%
