%%%%%%%%%%%%%%
% % % %%%  %.%
% % %   % %% %
%   % %   %% %
%% %% % % %% %
%%    % %    %
%%%% %% %%%%%%
%P   %%      % 
%%%%%%%%%%%%%%